111111111111111111111
1000C0000100000000001
100000000100000100001
1000C0000000001C10001
100000000100000E00001
100000000100000000001
1P00C0000100000000001
111111111111111111111